appinventor.ai_chaz1429.TwitterAppV2.apk	appinventor.ai_chaz1429.TwitterAppV2
Bigfool.ActBG593.apk	Bigfool.ActBG593
Bigfool.ActBGwww331.apk	Bigfool.ActBGwww331
Bigfool.ActBGwww438.apk	Bigfool.ActBGwww438
bighead.wallpaper.dongman.yinghua1.apk	bighead.wallpaper.dongman.yinghua1
biz.nlnqnrn.lnloknlnqnm.apk	biz.nlnqnrn.lnloknlnqnm
biz.nqnrnkn.koknlnlnr.apk	biz.nqnrnkn.koknlnlnr
cn.com.lw.LSD_03_monkey.apk	cn.com.lw.LSD_03_monkey
cn.com.lw.LS_eyeclass.apk	cn.com.lw.LS_eyeclass
cn.com.lw.LSK_02_naruto.apk	cn.com.lw.LSK_02_naruto
cn.com.opda.android.update.apk	cn.com.opda.android.update
cn.ggg.market.apk	cn.ggg.market
cn.konami.contraevo.apk	cn.konami.contraevo
com.adroidzstrone.flipjc.apk	com.adroidzstrone.flipjc
com.adroidzstrone.poolek.apk	com.adroidzstrone.poolek
com.androidbox.c15sjn1cnadm.apk	com.androidbox.c15sjn1cnadm
com.androidemu.nescjml.apk	com.androidemu.nescjml
com.android.mmreader372.apk	com.android.mmreader372
com.android.mmreader462.apk	com.android.mmreader462
com.android.mmreader590.apk	com.android.mmreader590
com.androidn.DragRacingPremium.apk	com.androidn.DragRacingPremium
com.angel.android.XMIDletoks.apk	com.angel.android.XMIDletoks
com.aob.android.cd.apk	com.aob.android.cd
com.apkol.flashtool.apk	com.apkol.flashtool
com.argt.moshen.apk	com.argt.moshen
com.august.game.apk	com.august.game
com.beckyben.candy.apk	com.beckyben.candy
com.bva.tki.apk	com.bva.tki
com.bytedroid.liveprints.apk	com.bytedroid.liveprints
com.calendar.example.apk	com.calendar.example
com.cieswa.wfwkfvul.apk	com.cieswa.wfwkfvul
com.cingkor.flashlight.apk	com.cingkor.flashlight
com.cooliris.media.apk	com.cooliris.media
com.corner23.android.universalandroot.apk	com.corner23.android.universalandroot
com.couple.ebook.qldmr.apk	com.couple.ebook.qldmr
com.df.zipper.apk	com.df.zipper
com.dis.counter.apk	com.dis.counter
com.droidsoft.landlords.apk	com.droidsoft.landlords
com.example.com.hjzq.game.apk	com.example.com.hjzq.game
com.gameloft.android.kkjcnsdjnbf.apk	com.gameloft.android.kkjcnsdjnbf
com.gamevisa8.fish.apk	com.gamevisa8.fish
com.geeksville.tracker.apk	com.geeksville.tracker
com.getjar.tju.tools.apk	com.getjar.tju.tools
com.halfbrick.fruitninjafree.apk	com.halfbrick.fruitninjafree
com.halvin.hstar.apk	com.halvin.hstar
com.hengtalk.BubbleBobble.apk	com.hengtalk.BubbleBobble
com.honeysoft.www.EEBNXBZNMCNVMHFJWERISMDFHJKA.apk	com.honeysoft.www.EEBNXBZNMCNVMHFJWERISMDFHJKA
com.hotty.fayu.apk	com.hotty.fayu
com.itxinke.doudizhu.apk	com.itxinke.doudizhu
com.jarebkstnhihekw.lkmgwdlfvhpt.apk	com.jarebkstnhihekw.lkmgwdlfvhpt
com.kiloo.subwaysurf.apk	com.kiloo.subwaysurf
com.kingroot.kinguser.apk	com.kingroot.kinguser
com.kkcsdjnjvdfvgf.android.tetris.apk	com.kkcsdjnjvdfvgf.android.tetris
com.kraqcjjsjskurlo.nqpanbrctlpuoh.apk	com.kraqcjjsjskurlo.nqpanbrctlpuoh
com.le2.kkjsdfndsjfbdfgfdg.cn.apk	com.le2.kkjsdfndsjfbdfgfdg.cn
com.light.sxing3.apk	com.light.sxing3
com.michael.bubbleshooter.bubble.apk	com.michael.bubbleshooter.bubble
com.mrvl.prmewp.maoeicqf.apk	com.mrvl.prmewp.maoeicqf
com.net.ford.wuzla.apk	com.net.ford.wuzla
com.noshufou.android.su.apk	com.noshufou.android.su
com.pashtet.blocks.apk	com.pashtet.blocks
com.pirateattack.pirateattack.apk	com.pirateattack.pirateattack
com.ponphy.appmanager.apk	com.ponphy.appmanager
com.rao.love.yy.zhajinhua.apk	com.rao.love.yy.zhajinhua
com.rc.QuickFixLagFix.apk	com.rc.QuickFixLagFix
com.sc.kanshu.apk	com.sc.kanshu
com.shao.piano.shaodd.apk	com.shao.piano.shaodd
com.soplite.katongfart.apk	com.soplite.katongfart
com.TeaM.Avatar.apk	com.TeaM.Avatar
com.TeaM.AvatarHD.apk	com.TeaM.AvatarHD
com.tebs3.switchpro.apk	com.tebs3.switchpro
com.tocdo.Avatar.apk	com.tocdo.Avatar
com.uuwldh.apk	com.uuwldh
com.vee.game12071218.apk	com.vee.game12071218
com.why.guess.apk	com.why.guess
com.ww.qinghe.book_1110007.apk	com.ww.qinghe.book_1110007
com.xy.game.zhaocha.apk	com.xy.game.zhaocha
com.xy.mobile.shaketoflashlight.apk	com.xy.mobile.shaketoflashlight
com.yuandroid.touchPTT.apk	com.yuandroid.touchPTT
com.z6root.qqkk.mneykuguo.apk	com.z6root.qqkk.mneykuguo
com.zhly.study.apk	com.zhly.study
com.zhwz.tom.pkemc.apk	com.zhwz.tom.pkemc
eiw.aiialnbbpg.qsdo.downo2.apk	eiw.aiialnbbpg.qsdo.downo2
gch.android.game.circelballs.apk	gch.android.game.circelballs
info.nonsnnn.loknlnonl.apk	info.nonsnnn.loknlnonl
info.npnsnsn.soknlnkno.apk	info.npnsnsn.soknlnkno
jp.ml.t_wl.ntgcvq.tjuctpc.olmk.apk	jp.ml.t_wl.ntgcvq.tjuctpc.olmk
kevin.crackedcarrot.menu.apk	kevin.crackedcarrot.menu
MagLite.SF3D.apk	MagLite.SF3D
mobi.rouwan.timezoneconvertor.apk	mobi.rouwan.timezoneconvertor
nang.dv.apk	nang.dv
net.nmnpnrn.toknlnnnk.apk	net.nmnpnrn.toknlnnnk
net.szym.barnacle.apk	net.szym.barnacle
net.wrzhi.zcyxzmqxl.apk	net.wrzhi.zcyxzmqxl
njsggwsc.yyh.apk	njsggwsc.yyh
nl.basecone.cloudia.apk	nl.basecone.cloudia
one.darwoo.marios.apk	one.darwoo.marios
org.lwm.www.mixedcolor.apk	org.lwm.www.mixedcolor
org.projectvoodoo.simplecarrieriqdetector.apk	org.projectvoodoo.simplecarrieriqdetector
pj.ishuaji.apk	pj.ishuaji
qsbk.app.apk	qsbk.app
rc.bdkgw.rmgkl.apk	rc.bdkgw.rmgkl
spfmissionx.spfmissionx.apk	spfmissionx.spfmissionx
sqm.elbblcebclqtq.pjjadngdba.apk	sqm.elbblcebclqtq.pjjadngdba
sunkay.Book16Tian.apk	sunkay.Book16Tian
Team.kpah.apk	Team.kpah
Team.MA2.core.apk	Team.MA2.core
ua.netlizard.seawar.apk	ua.netlizard.seawar
vipgame.sb.apk	vipgame.sb
whu.iss.sric.android.shaodd.apk	whu.iss.sric.android.shaodd
wuj.ijcdjrh.quoucufwt.apk	wuj.ijcdjrh.quoucufwt
